00122200001000111111111110002222100000000222222222
11110012222222210012100000110011111100122211000000
00001122222222111001122222222211122211112110012222
11000000001100122100011000001122222222210011000122
22221101222211111221001100001211112222221111100000
00001112212222211111111210001122211112112110111111
22110112221112210001110000122211000111122211000122
11111000121001110122210000122110000111111111122112
22222222222221101222221111110011222222001110122222
22221122111112222221111221101000011111000011000122
10001221110000000122111111122100001111000022222221
12212210122100001111110011111122100110012122100100
00111011100110000000001221122221111100001111111110
00110001111111222221111001100111112210001221000110
00011111100000011222111112220001000000101222111111
11001210000000122210001111100112222111001111222211
11001221000111012220011001122222211111122100012111
00112200012211122100122221112222222111110112221111
11110001111001111222222111111222100011111121100111
12110001111100000000012221100012210000110011100111
00000001122221111100012211112221111111222110001112
22221000000001111000111110111000000111211001100001
11122222222211222222112221000111000000000122221011
22110001122221111110000112222221011221112221100000
00012210122122222222221122210012211111111111111001
11011221121101222100011222111122111111100012211001
21001221000001101100000000111112211110022222222222
10022111222222210110012222221011112221100000111110
10001110001111111100121000001221001222210111110000
00111222222210001211011000111000012222222211222100
